Bae	Angela
Bang	Jung-A
Bass	Jonathan
Benjamin	Rebecca
Boudreau	Andrew
Chan	Angela Sin Ying
Chaplikov	Stefan
Chen	Audrey
Chen	Yandi
Choi	Jiyoung
Chou	Gabrielle
Coleridge	Brigid
Daly	Cameron
DeFilippis	Justin
Dionne	Lee
Doležal	Štěpán
Ekery	Amanda
Feil	Tim
Fellenberg	Miles
Fensome	Sonya Ovrutsky
Fišer	Jakub
Gabrielian	Tanya
Gadbow	Brian
Gagliano	Avery
Gallagher	Rosie
Garbot	Brandon
Goodpasture	Christopher
Gorini	Filippo
Gray	Evan
Grevious	Njioma
Ho	Jeffrey
Honn	Jillian
Horowitz	Ariel
Houston	Russell
Huang	Hilda
Jeong	Seolyeong
Ježek	Štěpán
Ji	David
Jiang	Yiliang
Johnson	Carter
Kanagawa	Mayumi
Kang	James
Kasdan	Becca
Kennedy	Eva
Kim	Jungeun
Kim	Stephen
Körting	Arianna
Krasner	Benjamin
Lee	Dongwon
Leunis	Anna
Lewis	Gregory
Li	Ying
Lin	Jenny
Lio	Kuok-Wai
Lorusso	James
Mak	Jonathan
Martins	Gabriel
Moses	Hannah
Nersessian	Pavel
Orth	Kyle
Orth	Rachel Arcega
Ozel	Evren
Park	Chaeyoung
Park	Chase
Park	Grace
Pinkas	Jiří
Poon	Tiffany
Qian	Anran
Robertson	Emma
Sasaki	Mika
Sekino	Yukiko
Spiegelberg	Yasmina
Stepanova	Liza
Strata	Gabriele
Szokolay	Sophia
Tekalli	Jamila
Tekalli	Suliman
Thomas	Martine
Tran	An
Vainshtein	Dina
Vardanega	Audrey
Wakao	Keila
Wang	Wynona
Wohlgemuth	Meredith
Wolf	Thomas
Wu	Yen-Chen
Xu	Alice Chenyang
Yao	Chengcheng
Zaks	Ilana
Zannoni	Benjamin
Zorman	Itamar
Zyzak	Stephanie
